R 1280 720

NO ./textures/greystone.xpm

SO ./textures/eagle.xpm

WE ./textures/red.xpm

EA ./textures/wood.xpm

S ./textures/minecraft_zombie.xpm

F 0, 153,0

C 204,255,255

1111111111111111111111111111111111
1000000N00000000100000000000000001
1000020000000000100000000000000001
1000000000000000100000000000000001
1111111100011111100000000000000001
1000000000000000000000000000000001
1000000000000000000000000000000001
1000000000000000000000000000000001
1000000002000000000000000000000001
1000000000000000000020000000000001
1000000000000100000000000000000001
1000000000000000000000000000000001
1000000000000200000000000200000001
1000000000000000000000000000000001
1000000000000000000000200000000001
1000000000000000000000000000000001
1000000000000000000000000000000001
1000000000000000000000000000000001
1000000000000000000000000000000001
1000000000000000000000000000000001
1000000000000000000000000000000001
1000000000000000000000000000000001
1000000000000000000000000000000001
1111111111111111111111111111111111