R 1280 720

NO ./textures/neo_wall.xpm

SO ./textures/neo_wall.xpm

WE ./textures/neo_wall.xpm

EA ./textures/neo_wall.xpm

S ./textures/beauty_squid.xpm

F 178, 102,255

C 0,255,255

1111111111111111
1111110000000111
1111000000000001
11100000000000001
110000000000000001
1000000002000000001
1000000000000000001
10000000000000000001
10000000000000000001
10000000000000000001
100000000N0000002001
10000000000000000001
10000000000000000001
10000000000000020001
1100000000000000001
1100000000000000001
111000000200000001
11110000000000001
1111110000000111
111111111111111